1111111111111111
1010000001000001
1010000001000001
1010011111001111
1000000000000001
1010111111100001
1010000000100001
1010000000100001
1111111111111111