400000000000000004
011111111111111110
010000611000101510
010101000010070010
010101111110111010
010070000000000010
010101110111011110

010100600001015710
010001010171000110
011111111111111110
400000000000000004