488888888888888884
811111111111111118
810000000100000018
81011111p001111018
816000000101000518
817101010171011018
810101010101p11018
810101010000000018
810000011010101018
810101000010070c18
810101111110111018
810000000000000018
810101110111011018
810100000001p10718
812001111100000118
811101888111101118
810001838888101018
81p101888810070018
810101111110111018
810070000000000018
810101110111010118
81010000s001010018
810001010101010118
810100010000000018
810101010101011018
81p171010101011018
816000000101070518
810111110101111018
81000000000000p018
811111111111111118
488888888888888884