488888888888888884
811111111111111118
810000611000101518
810101003010070018
810101111110111018
810070000000000018
810101110111011118
810100600001015718
812001010171000118
811111111111111118
488888888888888884